https://en.wiktionary.org/wiki/hello#Translations
Abkhaz: Ğ±Ğ·Ğ¸Ğ° Ğ·Ğ±Ğ°ÑˆĞ° (bzia zbaÅ¡a), Ğ¼Ñ‹Ñˆ Ğ±Ğ·Ğ¸ (mÉ™Å¡ bzi), (to a man) Ğ±Ğ·Ğ¸Ğ°Ñ€Ğ° ÑƒĞ±Ğ°Ğ°Ğ¸Ñ‚ (bziara ubaaiá¹­), (to a woman) Ğ±Ğ·Ğ¸Ğ°Ñ€Ğ° Ğ±Ğ±Ğ°Ğ°Ğ¸Ñ‚ (bziara bbaaiá¹­), (to more than one person) Ğ±Ğ·Ğ¸Ğ°Ñ€Ğ° Ğ¶Ó™Ğ±Ğ°Ğ°Ğ¸Ñ‚ pl (bziara Å¾Â°baaiá¹­)
Afrikaans: hallo (af), goeiedag
Ainu: ã‚¤ãƒ©ãƒ³ã‚«ãƒ©ã‡·ã‚šãƒ† (irankarapte)
Albanian: tungjatjeta (sq), tung (informal), Ã§'kemi m or f

    ArbÃ«reshÃ« Albanian: falem (sq)

Alemannic German: sÃ¤lÃ¼, hoi, hello
Aleut: aang, draas
Ambonese Malay: wai
American Sign Language: B@Sfhead-PalmForward B@FromSfhead-PalmForward
Amharic: áˆ°áˆ‹áˆ (sÃ¤lam)
Apache:

    Jicarilla: dÃ¡ nzhÇ«Ì
    Western Apache: dagotÊ¼ee, daÊ¼anzho, yaÊ¼ateh

Arabic: Ø§Ù„Ø³ÙÙ‘Ù„ÙØ§Ù…Ù Ø¹ÙÙ„ÙÙŠÙ’ÙƒÙÙ…Ù’â€ (ar) (as-salÄmu Ê¿alaykum), Ø³ÙÙ„ÙØ§Ù…â€ (ar) (salÄm), Ù…ÙØ±Ù’Ø­ÙØ¨Ù‹Ø§â€ (ar) (mará¸¥aban), Ø£ÙÙ‡Ù’Ù„Ù‹Ø§â€ (ar) (Ê¾ahlan)

    Egyptian Arabic: Ø§Ù‡Ù„Ø§Ù‹â€ (ahlan)
    Iraqi Arabic: Ù‡Ù„Ùˆâ€ (helaww)

Archi: ÑĞ°Ğ»Ğ°Ğ¼ Ğ°Ğ»ĞµĞ¹ĞºÑƒĞ¼ (salam alejkum), Ğ²Ğ°Ñ€Ñ‡Ó€Ğ°Ğ¼Ğ¸ (warÄÊ¼ami)
Armenian: Õ¢Õ¡Ö€Ö‡ (hy) (barew), Õ¸Õ²Õ»Õ¸Ö‚ÕµÕ¶ (hy) (oÅ‚Ç°uyn)
Assamese: à¦¨à¦®à¦¸à§à¦•à¦¾à§° (nomoskar) (very formal), à¦†à¦šà§à¦šà§‡à¦²à¦¾à¦®à§‹ à¦†à¦²à¦¾à¦‡à¦•à§‹à¦® (asselamÃ¼ alaikÃ¼m) (formal, used among Muslims), à¦¹à§‡à¦²â€™ (helÃ¶)
Assyrian Neo-Aramaic: Ü«Ü ÜµÜ¡ÜµÜâ€ (Å¡lama), (to a man) Ü«Ü ÜµÜ¡ÜµÜ Ü¥Ü²Ü Ü˜Ü¼ÜŸİ‚â€ (Å¡lama Ê¿Äloá¸³), (to a woman) Ü«Ü ÜµÜ¡ÜµÜ Ü¥Ü²Ü ÜµÜŸİ‚Üâ€ (Å¡lama Ê¿Älaá¸³), (to more than one person) Ü«Ü ÜµÜ¡ÜµÜ Ü¥Ü²Ü ÜµÜ˜ÜŸİ‚Ü˜Ü¿Ü¢â€ (Å¡lama Ê¿Äloá¸³on)
Asturian: hola (ast)
Azerbaijani: salam (az), sÉ™lam (South Azerbaijani), hÉ™r vaxtÄ±nÄ±z xeyir olsun, hÉ™r vaxtÄ±nÄ±z xeyir
Bashkir: ÑÓ™Ğ»Ó™Ğ¼ (sÃ¤lÃ¤m)
Basque: kaixo (eu)
Bats: please add this translation if you can
Bavarian: servus, grias di, pfiati (Timau)
Belarusian: Ğ²Ñ–Ñ‚Ğ°ÌÑ (vitÃ¡ju), Ğ·Ğ´Ğ°Ñ€Ğ¾ÌÑ (zdarÃ³Å­) (colloquial), Ğ´Ğ¾ÌĞ±Ñ€Ñ‹ Ğ´Ğ·ĞµĞ½ÑŒ (dÃ³bry dzjenÊ¹) (good day)
Bengali: à¦¨à¦®à¦¸à§à¦•à¦¾à¦° (bn) (nÃ´mÃ´Å›kar), à¦†à¦¸à¦¸à¦¾à¦²à¦¾à¦®à§à¦†à¦²à¦¾à¦‡à¦•à§à¦® (aÅ›Å›alamualaikum), à¦¸à¦¾à¦²à¦¾à¦® (Å›alam), à¦¹à§à¦¯à¦¾à¦²à§‹ (hjalo)
Bhojpuri: à¤ªà¥à¤°à¤£à¤¾à¤® (praá¹‡Äm)
Bouyei: mengz ndil
Bulgarian: Ğ·Ğ´Ñ€Ğ°ÌÑÑ‚Ğ¸ (bg) (zdrÃ¡sti) (familiar), Ğ·Ğ´Ñ€Ğ°Ğ²ĞµÌĞ¹ (bg) sg (zdravÃ©j) (familiar), Ğ·Ğ´Ñ€Ğ°Ğ²ĞµÌĞ¹Ñ‚Ğµ (bg) pl (zdravÃ©jte) (formal)
Burmese: á€™á€„á€ºá€¹á€‚á€œá€¬á€•á€« (my) (mangga.lapa) , á€Ÿá€²á€œá€­á€¯ (my) (hai:lui) (colloquial)
Catalan: hola (ca)
Cayuga: sgÄ™Ì:nÇ«Ê”
Central Atlas Tamazight: â´°âµ£âµ“âµ (azul)
Chamorro: hÃ¥fa adai
Chechen: Ğ¼Ğ°Ñ€ÑˆĞ°Ğ»Ğ»Ğ° Ğ´Ñƒ Ñ…ÑŒĞ¾ÑŒĞ³Ğ° (marÅ¡alla du á¸¥Ã¶ga) (to one person), Ğ¼Ğ°Ñ€ÑˆĞ°Ğ»Ğ»Ğ° Ğ´Ñƒ ÑˆÑƒÑŒĞ³Ğ° (marÅ¡alla du Å¡Ã¼ga) (to a group of people), Ğ°ÑÑĞ°Ğ»Ğ°Ğ¼Ñƒ ÓĞ°Ğ»Ğ°Ğ¹ĞºÑƒĞ¼ (assalamu Ê¿alajkum)
Cherokee: á£áá² (chr) (osiyo)
Chichewa: moni
Chickasaw: chokma
Chinese:

    Cantonese: ä½ å¥½ (nei5 hou2), å“ˆä½¬ (haa1 lou2)
    Dungan: Ğ½Ğ¸ Ñ…Ğ¾ (ni ho), ÑÑĞ»ÑĞ¼Ñƒ (seliÍ¡amu), Ñ…Ğ¾Ğ¼Ğ° (homa)
    Hakka: ä½ å¥½ (ngÃ¬-hÃ³)
    Mandarin: ä½ å¥½ (zh) (nÇ hÇo), æ‚¨å¥½ (zh) (nÃ­n hÇo) (polite), ä½ å€‘å¥½, ä½ ä»¬å¥½ (nÇmen hÇo) (to a group of people), å¥½ (zh) (hÇo) (following an address form or name), å—¨ (zh) (hÄi), å“ˆå›‰ (zh), å“ˆå•° (zh) (hÄluÃ³)
    Min Dong: æ±å¥½ (ná¹³Ì„ hÅÌ¤)
    Min Nan: æ±å¥½ (lÃ­ hÃ³)
    Xiang: please add this translation if you can
    Wu: å„‚å¥½, ä¾¬å¥½ (non hau)

Choctaw: halito
Chukchi: ĞµÑ‚Ñ‚Ñ‹Ğº (ettyk) (formal), ĞµÑ‚Ğ¸ (eti) (informal), ĞµÑ‚Ñ‚Ğ¸ (etti) (informal)
Coptic: â²›â²ŸÏ¥â²£â²“ (nofri)
Cornish: dydh da
Corsican: bonghjornu
Cree:

    Plains Cree: tÃ¢nisi 

Czech: ahoj (cs), nazdar (cs) (informal), servus (cs) (informal), dobrÃ½ den (cs) (formal)
Danish: hej (da), dav (da), god dag (formal), hallo (da)
Dhivehi: Ş‡Ş¦Ş‡Ş°ŞŞ¦ŞŞ§Ş‰Şª Ş¢Ş¦ŞŞ¦Ş‡Ş¨Ş†ŞªŞ‰Ş°â€ (assalÄmu Ê¿alaikumÌŠ)
Dutch: hallo (nl), hoi (nl), hai (nl), hÃ© (nl), dag (nl) (informal), goeiedag (nl), goededag (nl), goedendag (nl), goeiendag (nl) (formal)
Esperanto: saluton (eo)
Estonian: tere (et), hei (et)
Faroese: hey, hallÃ³
Fijian: bula (fj)
Finnish: terve (fi), moi (fi), hei (fi), moikka (fi)
French: bonjour (fr), salut (fr) (informal), coucou (fr)(informal), cocorico (fr)
Friulian: mandi
Galician: ola (gl), oula, ouga
Georgian: áƒ’áƒáƒ›áƒáƒ áƒ¯áƒáƒ‘áƒ (ka) (gamarÇ¯oba), áƒ°áƒ”áƒ˜ (hei)
German: hallo (de), guten Tag (de), servus (de), moin (de), grÃ¼ÃŸ Gott (de) (Southern German, Austria)

    Alemannic German: grÃ¼ezi

Gilbertese: mauri
Gothic: ğŒ·ğŒ°ğŒ¹ğŒ»ğƒ (hails), ğŒ·ğŒ°ğŒ¹ğŒ»ğŒ° (haila)
Greek: Î³ÎµÎ¹Î± (el) (geia), Î³ÎµÎ¹Î± ÏƒÎ¿Ï… sg (geia sou), Î³ÎµÎ¹Î± ÏƒÎ±Ï‚ pl (geia sas), Ï‡Î±Î¯ÏÎµÏ„Îµ (el) (chaÃ­rete)

    Ancient: Ï‡Î±á¿–ÏÎµ sg (khaÃ®re), Ï‡Î±Î¯ÏÎµÏ„Îµ pl (khaÃ­rete), Ï‡Î±á¿–ÏÎµ ÎºÎ±Î¯ á½‘Î³Î¯Î±Î¹Î½Îµ sg (khaÃ®re kaÃ­ hugÃ­aine)

Greenlandic: aluu (kl)
GuaranÃ­: maitei (gn)
Gujarati: àª¨àª®àª¸à«àª¤à«‡ (namaste), àª¨àª®àª¸à«àª•àª¾àª° (namaskÄr)
Haitian Creole: bonjou
Hausa: sannu
Hawaiian: aloha
Hebrew: ×©Ö¸××œ×•Ö¹×â€ (he) (shalÃ³m), ×©Ö¸××œ×•Ö¹× ×¢Ö¸×œÖµ×™×›Ö¶×â€ (he) (shalÃ³m 'aleikhÃ©m)
Hindi: à¤¨à¤®à¤¸à¥à¤¤à¥‡ (hi) (namaste), à¤¨à¤®à¤¸à¥à¤•à¤¾à¤° (hi) (namaskÄr), à¤¸à¤²à¤¾à¤® (hi) (salÄm) (used by Muslims), à¤¸à¤¤ à¤¶à¥à¤°à¥€ à¤…à¤•à¤¾à¤² (sat Å›rÄ« akÄl) (Sikh, hello/goodbye), à¤¹à¥‡à¤²à¥‹ (hi) (helo), à¤¹à¤²à¥‹ (halo), à¤¸à¤¤à¥à¤¯ (hi) (satya), à¤†à¤¦à¤¾à¤¬ (hi) (ÄdÄb)
Hmong:
    Green Hmong: nyob zoo
    White Hmong: nyob zoo
Hungarian: szia (hu), sziasztok (hu) pl (informal), szervusz (hu), szervusztok pl (somewhat formal), helÃ³ (hu), hellÃ³ (hu) (informal), jÃ³ napot (hu), jÃ³ napot kÃ­vÃ¡nok (hu) (formal), Ã¼dvÃ¶zlÃ¶m
Icelandic: hallÃ³ (is), hÃ¦ (is), gÃ³Ã°an dag (is), gÃ³Ã°an daginn (is)
Ido: hola (io)
Igbo: kÃ¨du
Indonesian: hai (id), salam (id)
Interlingua: bon die, salute (ia)
Irish: Dia dhuit (formal, singular), Dia dhaoibh (formal, plural), Dia's Muire dhuit (formal, singular, response), Dia's Muire dhaoibh (formal, plural, response)
Isan: please add this translation if you can
Italian: ciao (it), salve (it), buongiorno (it), saluti (it) m pl
Iu Mien: yiem longx nyei
Jamaican Creole: ello, wah gwaan
Japanese: ãŠã¯ã‚ˆã† (ja) (ohayÅ) (morning), ã“ã‚“ã«ã¡ã¯ (ja) (konnichi wa) (daytime), ã“ã‚“ã°ã‚“ã¯ (ja) (konban wa) (evening)
Javanese: halo
Jeju: ë°˜ê°‘ìˆ˜ë‹¤ (ban-gapsuda), íœì•ˆá„’á†ìš°ê½ˆ (pen-anhawukkwa), íœì•ˆ (pen-an)
Judeo-Tat: ÑˆĞ¾Ğ»ÑƒĞ¼ (ÅŸolum)
Kabardian: ÑƒÑƒĞ·Ñ‹Ğ½ÑˆÑĞ¼ (wwzÉ™nÅ¡Äƒm)
Kabyle: azul
Kalmyk: Ğ¼ĞµĞ½Ğ´Ğ²Ñ‚ (mendvt), Ğ¼ĞµĞ½Ğ´ (mend) (informal)
Kannada: à²¤à³à²³à²¿à²²à³ (kn) (tuá¸·ilu), à²¨à²®à²¸à³à²•à²¾à²° (kn) (namaskÄra)
Karachay-Balkar: ĞºÑĞ½ÑĞ³ÑĞ· Ğ°ÑˆÑ…Ñ‹ Ğ±Ğ¾Ğ»ÑÑƒĞ½ (kÃ¼nÃ¼gÃ¼z aÅŸxÄ± bolsun), Ğ°ÑÑĞ°Ğ»Ğ°Ğ¼Ñƒ Ğ°Ğ»ĞµĞ¹ĞºÑƒĞ¼ (assalamu aleykum)
Karelian: terveh, hei
Kazakh: ÑÓ™Ğ»ĞµĞ¼ (kk) (sÃ¤lem) (informal), ÑÓ™Ğ»ĞµĞ¼ĞµÑ‚ÑÑ–Ğ·Ğ´ĞµÑ€ (sÃ¤lemetsÄ±zder) (formal)
Khmer: á‡áŸ†ášá¶á”áŸá½áš (cumriÉ™p suÉ™), áŸá½áŸáŸ’áá¸ (suÉ™sdÉ™y)
KhÃ¼n: please add this translation if you can
Kinyarwanda: muraho
Korean: ì•ˆë…•í•˜ì‹­ë‹ˆê¹Œ (annyeonghasimnikka) (formal), ì•ˆë…•í•˜ì„¸ìš” (ko) (annyeonghaseyo) (neutrally formal), ì•ˆë…•(å®‰å¯§) (ko) (annyeong) (informal)
Krio: kushÉ›
Kurdish:

    Northern Kurdish: merheba (ku), silav (ku), selam (ku)

Kyrgyz: ÑĞ°Ğ»Ğ°Ğ¼Ğ°Ñ‚ÑÑ‹Ğ·Ğ´Ğ°Ñ€Ğ±Ñ‹ (salamatsÄ±zdarbÄ±), ÑĞ°Ğ»Ğ°Ğ¼ (ky) (salam)
Ladino: shalom, bonjur, buenos diyas
Lak: ÑĞ°Ğ»Ğ°Ğ¼ (salam)
Lakota: hÃ¡u
Lao: àºªàº°àºšàº²àºàº”àºµ (sa bÄi dÄ«)
Latin: salvÄ“ (la) sg, salvÄ“te (la) pl; avÄ“ (la) sg, avÄ“te pl
Latvian: sveiki (informal to more than one person or people of indeterminate gender), sveiks (to a man), sveika (to a woman), Äau (informal)
Laz: áƒ’áƒ”áƒ’áƒáƒ¯áƒ’áƒ˜áƒœáƒáƒ¡ (gegaÇ¯ginas)
Lezgi: ÑĞ°Ğ»Ğ°Ğ¼ (salam)
Lithuanian: labas (lt), sveikas (lt) (informal), sveiki (lt) (formal)
Livonian: tÄ“riÅ†tÅ¡
Luo: msawa
LÃ¼: á¦á¦²á§ƒá¦¡á¦² (yiiná¸‹ii)
Luxembourgish: hallo
Macedonian: Ğ·Ğ´Ñ€Ğ°Ğ²Ğ¾ (zdravo)
Malagasy: manao ahoana? (mg), salama (mg) (Tsimihety)
Malay: helo (ms), apa khabar (ms), salam (ms)
Malayalam: à´¹à´²àµ‹ (halÅ), à´¨à´®à´¸àµà´¤àµ‡ (ml) (namastÄ“), à´¨à´®à´¸àµà´•à´¾à´°à´‚ (ml) (namaskÄraá¹ƒ)
Maltese: bonÄ¡u (mt) (before noon), bonswa (after noon), nsellimlek (formal one to one person), nsellmilkom (formal one to more than one person), nsellmulek (formal more than one person to one person), nsellmulkom (formal more than one person to more than one persons)
Manchu: á °á  á¡³á ¶á¡¡á ¨ (saiyÅ«n)
Maori: kia ora (mi) (informal), tÄ“nÄ koe (formal to one person), tÄ“nÄ kÅrua (formal to two people), tÄ“nÄ koutou (formal to three or more people)
Mapudungun: mari mari
Maranungku: yo
Marathi: à¤¨à¤®à¤¸à¥à¤•à¤¾à¤° (mr) (namaskÄr)
Michif: tÃ¡nishi, boÃ±jour
Mingrelian: áƒ’áƒáƒ›áƒáƒ áƒ«áƒ’áƒ£áƒ (gomorÊ’gua)
Mohawk: sekoh
Mongolian:

    Cyrillic: ÑĞ°Ğ¹Ğ½ ÑƒÑƒ? (mn) (sayn uu?) (informal), ÑĞ°Ğ¹Ğ½ Ğ±Ğ°Ğ¹Ğ½Ğ° ÑƒÑƒ? (mn) (sayn bayna uu?)

Mopan Maya: dÊ¼yoos
Nahuatl: niltze (nah), panoltih
Navajo: yÃ¡Ê¼Ã¡tÊ¼Ã©Ã©h
Neapolitan: uÃ¨
Nepali: à¤¨à¤®à¤¸à¥à¤¤à¥‡ (ne) (namaste), à¤¨à¤®à¤¸à¥à¤•à¤¾à¤° (ne) (namaskÄr)
Norman: baon-n-jour (Guernsey), banjour (Guernsey), boujouo (continental Normandy), bouÃ´njour (Jersey), bwÃµju (Sark)
Northern Thai: à¸ªà¸šà¸²à¸¢à¸”à¸µà¸à¹ˆà¸­
Norwegian:

    BokmÃ¥l: hallo (no), hei (no), god dag (no) (formal), halla (no) (informal), heisann

Ojibwe: boozhoo
Okinawan: ã¯ã„ã•ã„ m (haisai), ã¯ã„ãŸã„ f (haitai), ã¯ã„ n (hai)
Old English: wes hÄl
Oriya: à¬¨à¬®à¬¸à­à¬•à¬¾à¬° (or) (nÃ´mÃ´skarÃ´)
Ossetian: ÑĞ°Ğ»Ğ°Ğ¼ (salam), Ğ±Ğ°Ğ¹Ñ€Ğ°Ğ¹ (bajraj), Ğ°Ñ€Ñ„Ó• (arfÃ¦)
Palauan: alii
Pashto: Ø³Ù„Ø§Ù…â€ (ps) (salÄm), Ø³Ù„Ø§Ù… Ø§Ù„ÛÚ©â€ (slÄmÄlÃ©k), Ø§Ù„Ø³Ù„Ø§Ù… Ø¹Ù„ÙŠÚ©Ù…â€ (as-salÃ¡m alaykÃºm)
Persian: Ø³Ù„Ø§Ù…â€ (fa) (salÃ¢m), Ø³Ù„Ø§Ù… Ø¹Ù„ÛŒÚ©Ù…â€ (salÃ¢mo alaykom) (religious), Ø¯Ø±ÙˆØ¯â€ (fa) (dorud) (literary)
Pitcairn-Norfolk: watawieh
Polish: czeÅ›Ä‡ (pl) (informal), witaj (pl), witajcie, witam (more formal), dzieÅ„ dobry (pl) (formal), siema (pl) (informal), halo (pl) (on phone), serwus (pl) (colloquial), czeÅ›ka (colloquial), siemanero (colloquial)
Portuguese: oi (pt), olÃ¡ (pt), (slang) e aÃ­? (pt)
Punjabi: à¨¸à¨¤à¨¿ à¨¸à¨¼à©à¨°à©€ à¨…à¨•à¨¾à¨² (sati Å›rÄ« akÄl)
Rapa Nui: 'iorana
Romani: te aves baxtalo (to a male), te aves baxtali (to a female), te aven baxtale (to two or more people)
Romanian: salut (ro), bunÄƒ (ro), noroc (ro) (informal), bunÄƒ ziua (formal), servus (ro)
Russian: Ğ¿Ñ€Ğ¸Ğ²ĞµÌÑ‚ (ru) (privÃ©t) (informal), Ğ·Ğ´Ğ¾Ñ€Ğ¾ÌĞ²Ğ¾ (ru) (zdorÃ³vo) (colloquial), Ğ·Ğ´Ñ€Ğ°ÌĞ²ÑÑ‚Ğ²ÑƒĞ¹Ñ‚Ğµ (ru) (zdrÃ¡vstvujte) (formal, first "Ğ²" is silent), Ğ´Ğ¾ÌĞ±Ñ€Ñ‹Ğ¹ Ğ´ĞµĞ½ÑŒ (ru) (dÃ³bryj denÊ¹), Ğ·Ğ´Ñ€Ğ°ÌĞ²ÑÑ‚Ğ²ÑƒĞ¹ (ru) (zdrÃ¡vstvuj) (informal, first "Ğ²" is silent), ÑĞ°Ğ»ÑÌÑ‚ (ru) (saljÃºt)
Rusyn: Ğ½Ğ°Ğ·Ğ´Ğ°Ñ€ (nazdar)
Sami:

    Inari Sami: tiervÃ¢
    Northern: dearvva, bÅ«res
    Skolt: tiÃµrv
    Southern: buaregh

Samoan: talofa
Sanskrit: à¤¨à¤®à¤¸à¥à¤•à¤¾à¤° (sa) (namaskÄra), à¤¨à¤®à¤¸à¥à¤¤à¥‡ (namaste), à¤¨à¤®à¥‹ à¤¨à¤®à¤ƒ (namo namaá¸¥) (formal)
Scots: hullo
Scottish Gaelic: halÃ² (informal), latha math (formal), (informal) hÃ²igh
Serbo-Croatian:

    Cyrillic: Ğ·Ğ´Ñ€Ğ°ÌĞ²Ğ¾, Ñ›Ğ°Ì‘Ğ¾, Ğ¼ĞµÌÑ€Ñ…Ğ°Ì„Ğ±Ğ°, ÑĞµĞ»Ğ°Ğ¼, Ğ±Ğ¾Ğ³, Ğ±Ğ¾Ğº
    Roman: zdrÈvo (sh), Ä‡Èƒo (sh), mÈ…rhÄba, selam (sh), bog, bok (sh)

Sesotho: lumela
Shan: please add this translation if you can
Shona: mhoro
Sichuan Yi: please add this translation if you can
Sicilian: ciao, salutamu
Sindhi: Ù‡ÙŠÙ„Ùˆâ€
Sinhalese: à·„à¶½à· (halÅ), à¶†à¶ºà·”à¶¶à·à·€à¶±à·Š (si) (ÄyubÅwan)
Situ: please add this translation if you can
Slovak: ahoj (sk), nazdar (informal), servus (sk) (informal), dobrÃ½ deÅˆ (formal)
Slovene: Å¾Ã­vjo, zdrÃ¡vo (informal), dÃ³ber dÃ¡n, pozdravljeni (formal)
Somali: ma nabad baa, waa nabad
Sorbian:

    Lower Sorbian: dobry ÅºeÅ„

Sotho: dumela (st)
Spanish: hola (es), buenos dÃ­as (es), quÃ© tal, buenas tardes (es)
Sundanese: halo
Svan: áƒ®áƒáƒ©áƒ áƒšáƒáƒ“áƒÌˆáƒ¦ (xoÄa ladÃ¤É£)
Swahili: jambo (sw), salaam
Swedish: hallÃ¥ (sv), hej (sv), god dag (sv) (formal), tjena (sv), hejsan (sv) (informal), tja (sv)
Tagalog: kamusta (tl)/kumusta (tl), musta (tl) (slang), hoy (tl), huy, oy/oi (informal), uy/ui (informal)
Tajik: ÑĞ°Ğ»Ğ¾Ğ¼ (salom)
Tamil: à®µà®£à®•à¯à®•à®®à¯ (ta) (vaá¹‡akkam)
Tangsa: Ã¤shazhoix
Tatar: ÑÓ™Ğ»Ğ°Ğ¼ (tt) (sÃ¤lam)
Telugu: à°¨à°®à°¸à°•à°¾à°°à°‚ (namasakÄraá¹), à°¬à°¾à°—à±à°¨à±à°¨à°¾à°°à°¾ (bÄgunnÄrÄ)
Tetum: please add this translation if you can
Thai: à¸ªà¸§à¸±à¸ªà¸”à¸µ (th) (sÃ -wÃ t-dii), à¸ªà¸§à¸±à¸ªà¸”à¸µà¸„à¸£à¸±à¸š (male speaker), à¸ªà¸§à¸±à¸ªà¸”à¸µà¸„à¹ˆà¸° (female speaker), à¸«à¸§à¸±à¸”à¸”à¸µ (wÃ t-dii)
Tibetan: à½–à½€à¾²à¼‹à½¤à½²à½¦à¼‹à½–à½‘à½ºà¼‹à½£à½ºà½‚à½¦ (bkra shis bde legs)
Tigrinya: áˆ°áˆ‹áˆ (sÃ¤lam)
Tongan: mÄlÅ e lelei
Tswana: dumela (tn) (singular, as in dumela, rra, "hello sir"), dumelang (tn) (plural, as in dumelang, borra, "hello gentlemen")
Turkish: merhaba (tr), selam (tr)
Turkmen: salam
Tuvan: ÑĞºĞ¸Ğ¸ (ekii)
Udmurt: ÓŸĞµÑ‡ (dÅºeÄ‡), Ñ‡Ñ‹Ñ€Ñ‚ĞºĞµĞ¼ (Ä‡yrtkem), ÑƒĞ¼Ğ¾Ğ¹ (umoj)
Ukrainian: Ğ¿Ñ€Ğ¸Ğ²Ñ–ÌÑ‚ (uk) (pryvÃ­t) (informal), Ğ·Ğ´Ğ¾Ñ€Ğ¾ÌĞ² Ğ±ÑƒĞ² (uk) (zdorÃ³v buv) (informal), Ğ´Ğ¾Ğ±Ñ€Ğ¸ÌĞ´ĞµĞ½ÑŒ (uk) (dobrÃ½denÊ¹) (neutral or formal), Ñ‡Ğ¾Ğ»Ğ¾ÌĞ¼ (ÄolÃ³m)
Urdu: Ø³Ù„Ø§Ù… Ø¹Ù„ÛŒÚ©Ù…â€ (salÄm-o-alaikum), Ø§Ø³Ù„Ø§Ù… Ø¹Ù„ÛŒÚ©Ù…â€ (literally â€œPeace be upon youâ€), Ø§Ø³Ù„Ø§Ù… Ø¹Ù„ÛŒÚ©Ù… ÙˆØ±Ø­Ù…ÛƒØ§Ù„Ù„Û ÙˆØ¨Ø±Ú©Ø§ØªÛâ€ (literally â€œPeace be upon you & May Allah blessâ€), Ø¢Ø¯Ø§Ø¨â€ (ur) (ÄdÄb)
Uyghur: Ø³Ø§Ù„Ø§Ù…â€ (salam)
Uzbek: salom (uz)
Venetian: ciao (vec)
Vietnamese: xin chÃ o (vi), chÃ o (vi)
VolapÃ¼k: glidis
Walloon: bondjoÃ» (wa), a (wa), diewÃ¥de (wa) (old)
Welsh: helo (cy), bore da (good morning), dydd da (good day), hylo
West Frisian: hallo, hoi
Winnebago: haho (male speaker), hÄ… (female speaker), hinÄ¯karaginÊ¼
Xhosa: molo sg, molweni pl
Xibe: á ªá  á¡³á¡¨á  á¡´á¡¡
á ¨á   (baitakÅ« na)
Yakut: ÑÒ•ÑÑ€Ğ´Ñ (eÄŸerde), Ğ´Ğ¾Ñ€Ğ¾Ğ¾Ğ±Ğ¾ (doroobo) (informal)
Yiddish: ×©×œ×•×Ö¾×¢×œ×™×›×â€ (sholem-aleykhem), ×Ö· ×’×•×˜×Ÿâ€ (yi) (a gutn), ×’×•×˜Ö¾××Ö¸×¨×’×Ÿâ€ (yi) (gut-morgn)
Yoruba: Páº¹láº¹ o
Yup'ik: waqaa, cama-i
Zapotec: padiull
Zazaki: sÄ±lam, namaste
Zhuang: mwngz ndei
Zulu: sawubona (zu) (familiar), sanibonani (plural, respectful)
